Artikel	der
Diskussion	die
Jahr	das
Zeit	die
Mai	der
Stadt	die
Teil	der
Berlin	das
Ende	das
Deutschland	das
August	der
Band	das
Gemeinde	die
Januar	der
März	der
Oktober	der
Universität	die
September	der
Juni	der
April	der
Kirche	die
Juli	der
Dezember	der
Jahrhundert	das
Geschichte	die
November	der
Verlag	der
Platz	der
Name	der
Seite	die
Februar	der
Mitglied	das
Film	der
Relevanz	die
Saison	die
Ort	der
Art	die
München	das
Benutzer	der
Benutzerin	die
Leben	das
Sohn	der
Familie	die
Mensch	der
Friedrich	der
Titel	der
Fall	der
Liste	die
Form	die
Wien	das
Karl	der
Hans	der
Meter	der
Beispiel	das
Johann	der
Frage	die
Schloss	das
Gruppe	die
Unternehmen	das
Peter	der
Anfang	der
Arbeit	die
Bereich	der
Frau	die
Bild	das
Tod	der
Wilhelm	der
Land	das
Gebiet	das
Bedeutung	die
König	der
Welt	die
Straße	die
Person	die
Begriff	der
Name	der
Kategorie	die
Mitte	die
Heinrich	der
