Adresse	Adressen
Apfel	Äpfel
Banane	Bananen
Birne	Birnen
Brot	Brote
Bruder	Brüder
Brötchen	Brötchen
Buchstabe	Buchstaben
Ei	Eier
Foto	Fotos
Frau	Frauen
Freund	Freunde
Freundin	Freundinen
Großmutter	Großmütter
Hotel	Hotels
Information	Informationen
Joghurt	Joghurts
Kartoffel	Kartoffeln
Kind	Kinder
Kiwi	Kiwis
Kuchen	Kuchen
Land	Länder
Mann	Männer
Mutter	Mütter
Name	Namen
Saft	Säfte
Schwester	Schwestern
Sohn	Söhne
Stadt	Städte
Tomate	Tomaten
Traube	Trauben
Vater	Väter
Wurst	Würste
Zahl	Zahlen
